SO ./textures/south.xpm
NO ./textures/north.xpm
WE ./textures/west.xpm
EA ./textures/east.xpm
F 135,206,255
C 255,255,255

        1111111111111111111111111
        1000000000000000000000001
        100000000000000000000W001
        1001000000000000000000001
111110111011000000000000000000001
100000000000000000000111111111111
1111011111111100000000001000011
1111011111111100000101001000111
1100000011010100000000001000001
1000000000000000000000000000111
1000000000000000000000000000111
1000000000000000000000000000111
1000000000000000000000000000111
1000000000000000000000000000111
1000000000000000000000000000111
1000000000000000000000000000111
1000000000000000000000000000111
1000000000000000000000000000111
1000000000000000000000000000111
1000000000000000000000000000111
1000000000000000000000000000111
1000000000000000000000000000111
1000000000000000000000000000111
1000000000000000000000000000111
1000000000000000000000000000111
1000000000000000000000000000111
1000000000000000000000000000111
1000000000000000000000000000111
1000000000000000000000000000111
1000000000000000000000000000111
1000000000000000000000000000111
1000000000000000000000000000111
1000000000000000000000000000111
1000000000000000000000000000111
1000000000000000000000000000111
1000000000000000000000000000111
1000000000000000000000000000111
1000000000000000000000000000111
1000000000000000000000000000111
1000000000000000000000000000111
1000000000000000000000000000111
1000000000000000000000000000111
1000000000000000000000000000111
1000000000000000000000000000111
1000000000000000000000000000111
1000000000000000000000000000111
1000000000000000000000000000111
1000000000000000000000000000111
1000000000000000000000000000111
1000000000000000000000000000111
1000000000000000000000000000111
1000000000000000000000000000111
1000000000000000000000000000111
1000000000000000000000000000111
1000000000000000000000000000111
1000000000000000000000000000111
1000000000000000000000000000111
1000000000000000000000000000111
1000000000000000000000000000111
1000000000000000000000000000111
1000000000000000000000000000111
1000000000000000000000000000111
1000000000000000000000000000111
1000000000000000000000000000111
1000000000000000000000000000111
1000000000000000000000000000111
1000000000000000000000000000111
1000000000000000000000000000111
1000000000000000000000000000111
1000000000000000000000000000111
1000000000000000000000000000111
1000000000000000000000000000111
1000000000000000000000000000111
1000000000000000000000000000111
1000000000000000000000000000111
1000000000000000000000000000111
1000000000000000000000000000111
1000000000000000000000000000111
1000000000000000000000000000111
1000000000000000000000000000111
1000000000000000000000000000111
1000000000000000000000000000111
1000000000000000000000000000111
1000000000000000000000000000111
1000000000000000000000000000111
1000000000000000000000000000111
1000000000000000000000000000111
1000000000000000000000000000111
1000000000000000000000000000111
1000000000000000000000000000111
1000000000000000000000000000111
1000000000000000000000000000111
1000000000000000000000000000111
1000000000000000000000000000111
1000000000000000000000000000111
1000000000000000000000000000111
1000000000000000000000000000111
1000000000000000000000000000111
1000000000000000000000000000111
1000000000000000000000000000111
1000000000000000000000000000111
1000000000000000000000000000111
1000000000000000000000000000111
1000000000000000000000000000111
1000000000000000000000000000111
1000000000000000000000000000111
1000000000000000000000000000111
1000000000000000000000000000111
1000000000000000000000000000111
1000000000000000000000000000111
1000000000000000000000000000111
1000000000000000000000000000111
1000000000000000000000000000111
1000000000000000000000000000111
1000000000000000000000000000111
1000000000000000000000000000111
1000000000000000000000000000111
1000000000000000000000000000111
1000000000000000000000000000111
1000000000000000000000000000111
1000000000000000000000000000111
1000000000000000000000000000111
1000000000000000000000000000111
1000000000000000000000000000111
1000000000000000000000000000111
1000000000000000000000000000111
1000000000000000000000000000111
1000000000000000000000000000111
1000000000000000000000000000111
1000000000000000000000000000111
1000000000000000000000000000111
1000000000000000000000000000111
1000000000000000000000000000111
1000000000000000000000000000111
1000000000000000000000000000111
1000000000000000000000000000111
1000000000000000000000000000111
1000000000000000000000000000111
1000000000000000000000000000111
1000000000000000000000000000111
1000000000000000000000000000111
1000000000000000000000000000111
1000000000000000000000000000111
1000000000000000000000000000111
1000000000000000000000000000111
1000000000000000000000000000111
1000000000000000000000000000111
1000000000000000000000000000111
1000000000000000000000000000111
1000000000000000000000000000111
1000000000000000000000000000111
1000000000000000000000000000111
1000000000000000000000000000111
1000000000000000000000000000111
1000000000000000000000000000111
1000000000000000000000000000111
1000000000000000000000000000111
1000000000000000000000000000111
1000000000000000000000000000111
1000000000000000000000000000111
1000000000000000000000000000111
1000000000000000000000000000111
1000000000000000000000000000111
1000000000000000000000000000111
1000000000000000000000000000111
1000000000000000000000000000111
1000000000000000000000000000111
1000000000000000000000000000111
1000000000000000000000000000111
1000000000000000000000000000111
1000000000000000000000000000111
1000000000000000000000000000111
1000000000000000000000000000111
1000000000000000000000000000111
1000000000000000000000000000111
1000000000000000000000000000111
1000000000000000000000000000111
1000000000000000000000000000111
1000000000000000000000000000111
1000000000000000000000000000111
1000000000000000000000000000111
1000000000000000000000000000111
1000000000000000000000000000111
1000000000000000000000000000111
1000000000000000000000000000111
1000000000000000000000000000111
1000000000000000000000000000111
1000000000000000000000000000111
1000000000000000000000000000111
1000000000000000000000000000111
1000000000000000000000000000111
1000000000000000000000000000111
1000000000000000000000000000111
1000000000000000000000000000111
1000000000000000000000000000111
1000000000000000000000000000111
1000000000000000000000000000111
1000000000000000000000000000111
1000000000000000000000000000111
1000000000000000000000000000111
1000000000000000000000000000111
1000000000000000000000000000111
1000000000000000000000000000111
1000000000000000000000000000111
1000000000000000000000000000111
1000000000000000000000000000111
1000000000000000000000000000111
1000000000000000000000000000111
1000000000000000000000000000111
1000000000000000000000000000111
1000000000000000000000000000111
1000000000000000000000000000111
1000000000000000000000000000111
1000000000000000000000000000111
1000000000000000000000000000111
1000000000000000000000000000111
1000000000000000000000000000111
1000000000000000000000000000111
1000000000000000000000000000111
1000000000000000000000000000111
1000000000000000000000000000111
1000000000000000000000000000111
1000000000000000000000000000111
1000000000000000000000000000111
1000000000000000000000000000111
1000000000000000000000000000111
1000000000000000000000000000111
1000000000000000000000000000111
1000000000000000000000000000111
1000000000000000000000000000111
1000000000000000000000000000111
1000000000000000000000000000111
1000000000000000000000000000111
1000000000000000000000000000111
1000000000000000000000000000111
1000000000000000000000000000111
1000000000000000000000000000111
1000000000000000000000000000111
1000000000000000000000000000111
1000000000000000000000000000111
1000000000000000000000000000111
1000000000000000000000000000111
1000000000000000000000000000111
1000000000000000000000000000111
1000000000000000000000000000111
1000000000000000000101001000001
1100000111010101111101111000111
11110111 1110101 101111010001
11111111 1111111 111111111111
