NO ./textures/north.xpm
SO ./textures/south.xpm
WE ./textures/west.xpm
EA ./textures/east.xpm

F 135,206,255
C 255,255,255

1111111111111111111111111
1000000000000000000000001
1000000000000000000000001
10001000000N0010101010001
1000000000000000000000001
1000100000100000000010001
1000000000000000000000001
1000101010100010101010001
1000000000000000000000001
1000000000100010000000001
1000000000000000000000001
1000000000100010101010001
1000000000000000000000001
1000000000000000000000001
1000000000000000000000001
1000000000000000000000001
1111111111111111111111111

