NO ./textures/north.xpm
SO ./textures/south.xpm
WE ./textures/west.xpm
EA ./textures/east.xpm

F 255,206,0,0
C 255,255,255

        1111111111111111111111111
        1000000000110000000000001
        10110001011100000000N0011
        1001000000000000000000001
111011111011000001110000000000001
100000000011000001110111111111111
1111011111111101110000001000011
1111011111111101110101001000111
1100000011010101110000001000001
1000000000000000110000000000111
1000000000000000110101001000001
1100000111010101111101111000111
11110111111111011111111110001
11111111111111111111111111111